%%%%%%%%%%%%%%%%%%%%
%              GGG %
%                  %
%                  %
%     %            %
%%%%%%%    %       %
%     %    %      .%
%     %    %       %
%     %    %P      %
%          %%%%%%%%%
%          %  G    %
%          %       %
%                  %
%%%%%%%%%%%%%%%%%%%%
% % % % %%%%%%%%%%%%
%%%%%%%%%%%%%%%%%%%%
